111111 1111111
10010000000C1
10000111c1100
1111111111111