11111111111111111111111111111111111111111
10110000000100001C00010001000000000000001
10010000000000000000000000000000000000001
10010000001100011100111011100000000000001
1101000000010000C100001000100000000000001
10000000000100011100111000100000000000001
1000000000010C00010000100C100000000000001
10000000001110011100111000100000000000001
10000000000000000000000000000000000000001
100000000000E0001000010000100000000000001
101010101001C100100001000010101C1010101P1
11111111111111111111111111111111111111111