1111111111111111111111111111111111
10E0000000000000000000000000000001
10100101001000001010010000000100P1
1010010010101010001001000C00010101
1000000000000000000000000C000000C1
1111111111111111111111111111111111