11111111111111111111111111111111111111111
10110000000000001N000000000P00E0000000011
101100000000000011C1111111111111111111111
11111111111111111111111111111111111111111