111111111111111111111111111111111111111111
100000000000000000000000000000000000000001
100C00000000000000000000000000000000000001
100000000000000000000000000000000000000001
100000000000000000000000000000000000000001
100000000000000000000000000000000000000001
100000000000000000000000000000000000000001
100000000000000000000000000000000000000001
100000000000000000000000000000000000000001
100000000000000101010000000000000000000001
100000000000000000010000000000000000000001
100000000000100000000000000000000000000001
100000000000100000000000000000000000000001
100000000000010000000000000000000000000001
100000000000000000000000000000000000000001
100000000000010000000000000000000000000001
100000000000000000000000000000000000000001
100000000000000000000000000000000000000001
100000000000000000000000000000000000000001
100000000000000000000000000000000000000001
1000000P00000000000000E0000000000000000001
111111111111111111111111111111111111111111